/----------------------------------------------------------------------------------------------------/
| R      R  R   RR     R            R R            R      R         RR                    R R      RR|
|    R RR R            RR               R   R      R R     R               R    RR          R R    R |
| R        RRR  RR       R    R  R R       R        RRR       RR     R      R     R   R      RR     R|
|  R             R  RR       R          RRRR    R    R    R    RR   RR     R   R R RR    R   R R    R|
|   RRRR   R         R  R   R               R       RRRR  RR     R  RR   R R       R         R  R  RR|
|    RR R       R  RR       R          R R          R       R   R R RR     R      R R          R     |
|    R        R   R      R       R         R          RRRRR R                  R      R      R     R |
|   RR      R  RRR R      R R R      RR    RR  R       R           RR      R        R R R      R    R|
|    R       R R   R    R     R       R    R   R       RR  R     R  R      R      R            R  RR |
|RR              RR  R   R  RR           R RR      R     R   R      R   R   R              R        R|
|  R   R              R R   R     R        R     R     R            R     R     R   R R R          R |
| RRRR       RR R   R R             R      R    R  R       R       RR      RR      R   R    R RR  R  |
|   R  R     R     R  R      RR     R     R R    RR  RR      R      R           R     R R R  RR R R  |
|    R      R   R         R                R    RR   R R           RR     R R      R  RR           R |
|   RR  R R  R R          R  RR        R  RRR            R  R       R      R          R R      R  R  |
|R    R R     RRRRR     RR    R        R       R  R   R   R    RRRR R R     R        RR      R     R |
|   RR RR         RR                  R    R  RRR           R   R  RR   RR  R        R RR          R |
|  R      R R            R    R            RR R                    RR                R    R  R     R |
| R  R        RR    R      R   R     R  R      R    R  RRR R  R     R RR   R   R     R    R R   R  RR|
| R            R R  R  R       R      R        R                   RR    R   RR R  R               R |
|R   R      R         R R   RR   R    R    RR   R    R   R R       R                      R    R   R |
|   R  R R  R R   R     RR                  R           R    R   R RR          R       R      R    RR|
|         RRRR R        R   R   R R    R   RR R R                      R   R   R     R   R      R   R|
| R    R  RRR R                     R   R  RR  R        R       R         RR  R     R  RR   R   R R  |
|      R     RRR   R  RRR   R  R           RR  R        R          RR    R R                      RR |
|R      R     RR        R    R             R      R    R     R   RRRR       R       R        R     RR|
|R  R R    RR  R                  R       R R     R  R       R   R  R   RR  R R R    RR  R  R      RR|
|R                R      R     R R  R   R  R   R       R    R     RR      R           R R R        RR|
|  R  R     R RR      RR RR RR RR          R R R        R    R    RR       RR         R      RR      |
|    R   R R R        R  R  R   R        R                         RR              R RRR         R  R|
|   R     R RR       R  R R             R   R       R R       R    R  R   R          RR     R        |
|      R            R   RRR        R      RRR           R     R    RR    RR        R  R           RR |
|  RR    R         R    R       R     R        R        RR  R      R              R R   R          RR|
|R  R  R  R  R R         R  R     RR     R RR   R   R  R  RR  R      RR           R  R   R     RRR RR|
|   R  RR R R  R     R  RR  R    RR RR     RR R    R RR    R     R   R    R           R      R     R |
| RRR RR     RR R  R R  R     R      R    R    R     R R      R     RR     RR    RR RRR   R         R|
| RRR        R  R        R             R   R R       RRRRR       RR  RR R      RR    RR R  R        R|
|      R   R  R    R    R RR             RRR   R R  RRR   R         R R R        R    R       R  R RR|
|      R          R     RRR R R           R   R R        R         RR    R           RRR      R    RR|
|   R  R R   R      R  R  R RR    R     R     R  R    RR  R        RRR     R  RRR R           R R    |
|         R    RR    R  R   R         R      R   R     R R   R       RR      R   R                   |
| RR  RR R     R R R   RR R R R            R  R      R R  R     R    R    RR R R                    R|
|RR    R      R  R   R  R                 R  RR R R  R R R      R RRR        R         R      R    R |
| R R   RR R      R     R   R R     R      R   R  R       RRR R   RRR    R  R                 RR   RR|
|   R   R  RRR RR        R   R       RR   RR   R     R             R       RR                  R    R|
|       R R   R  R  R   R    RR       R     R  R     R  R   R      RRR     RRR R  R   RR      R     R|
|        R       R R     R            R      R        R  RR R       R       RR R             R R    R|
| R RRR RRR      R      R    R        RRR  R           R R   R     RR R R       RR            R      |
|    R  R          RR    R  R      R      R R R          R          R                  R      R     R|
|      R   RR    R R   R     R    R   R R R          R R   R        RRR  R        RR          R      |
|RR   R    R   R R      R         R        R  RR   R           R   R R     RR R  R  RR   R  R        |
|  RR  RR        R          RR       RR   RRR     R            R R       R  R    RR    RR    R R     |
|     R   R       R     R   R              R    RR   RR          R          R    R    R             R|
|       R RR      R   R R   R         R    R          R  RR        RR      R    R     R         RRR R|
|    RRR R       RR                        R      R  R  R R R      RR            R     R    R     RR |
|       R     R R R          R             RRR R     RR    R       RR   R  R     R  RR       RR   RRR|
|     R           R   R R  RRRRR   R           R       R R RR      R          R      RR     R      RR|
|      R       R RR    R      RR           R     R    R     R    R RR            R     R  R    R     |
|  R  RR          R    RR R RR      R       R RR    R R R  R       RR   R        RR  RRR    R      RR|
|       R        RR  R                                         R   RR    RR R    R   R             RR|
|     R   R            R R  R              RR        R            R      RR      R     RRR   RR   RR |
|  R     RR     R    R     R RR            RR R               R  R       R            R     RRR    R |
|     R   RR    R           RR      R      R     R    RR   RR R    R           R RR                R |
|  R R    R        R   R      R           RR      RR    R          RR   R     R  R RR R    R  R    RR|
|         R   RR    R             RR       R R      R   RR         R R  R                         RRR|
|                      R     RR    RR          R      R      RR                 R   R  R             |
|R    R     R   R      RR    RR   R R          R  RR    R    R     R     R        R          R    R  |
|   R  R              R  R  RR         R    R   RR            R R   R             R                 R|
|                      R    RRR             F R        R            R           RR    R    R   RR R  |
|      R        R            R             R                  R R   R           RR                 RR|
|              R R  R        RRR                                  R  R    R  R R RR      R   R    RRR|
|                        R  RRR R R                          R      RR          R         R      RRR |
|                        R  RR      R      R R R                   RR R         R    R    R  R  R  RR|
|                                                  R         R      R     R     R    R            RR |
|                           RR                      R    R R R      R        R R      RR     R       |
|                                                       R          RR                   R   R     R R|
|                                                      R  R R      R   R      RR                     |
|                                                                              RR             R      |
|                                          R                 R       R          R                  R |
|                                                                             R  RR               RR |
|                           R               R               R       R   R R                         R|
|                                                       R          RR     R             R    R      R|
|                                                       R      R   R   R R              R          R |
|                                                                           R         R              |
|                                                                             R         R            |
|                                                                          R        R               R|
|                                                                                R R    R            |
|                                                                                         R        R |
|                                                                   R                              R |
|                                                                  F                                 |
|                                                                              R             R     R |
|                                                                                                    |
|                                                                                                    |
|                                                                                R          R      R |
|                                                                                     R            F |
|                                                                                                   R|
|                                                                  R                                 |
|                                                                                                    |
|                                                                                                    |
|                                                                   R                                |
/----------------------------------------------------------------------------------------------------/